You are a British sailor who is being held captive on a pirate ship. It is night time and most of the pirates are asleep, this is your only chance to get off of the pirate ship and make it out alive. If you escape the ship with your life you will be a legend amongst your British sailors. Good luck!

Pirate Ship Escape
An Interactive Fiction by ggrune20
Release 1 / Serial number 190422 / Inform 7 build 6M62 (I6/v6.33 lib 6/12N) SD

Holding Cell
The jail cell the pirates are keeping you hostage in. There is a tiny barred off window that allows you to see the full moon, the stars in the night sky, and the oil colored ocean. The floor is made out of wooden floorboards and the walls are wood as well. To the north there is an old and rusty jail door.

You can see a Jail Door and loose floorboard here.

I beg your pardon?

* * *

>break floorboard
Violence isn't the answer to this one.

>break loose floorboard
Violence isn't the answer to this one.

* * *

>break loose floorboard
You can't see any such thing.

>break floorboard
Violence isn't the answer to this one.

>break off loose floorboard
You can't see any such thing.

>break off floorboard
you manage to break off the loose floorboard. Maybe it can help you to get out of the holding cell.

* * *

>break off floorboard
you manage to break off the loose floorboard. Maybe it can help you to get out of the holding cell.

>pry jail door
(with loose floorboard)
you break open the jail door. North towards the cargo hold is the only way you can go.

* * *

>break off loose floorboard
you manage to break off the loose floorboard. Maybe it can help you to get out of the holding cell.

>break loose floorboard
Violence isn't the answer to this one.

>i
You are carrying:
  loose floorboard

>pry open door with floorboard
you break open the jail door. North towards the cargo hold is the only way you can go.

>n
Cargo Hold
A room where there is pirate clothing and other cargo. The Holding Cell is to the south and the Crew's Quarters are to the north. Be careful though, I wouldn't recommend going into the Crew's quarters... you don't look like a pirate at all. If you want to go up, there is a small ladder you can climb to the Center Deck.

You can see a Jail Door, eyepatch and pirate coat here.

>u
Center Deck
As you stand in the center deck you catch the scent of bread coming from the south, the Captain's Quarters. The entry door leads to the Captain's Quarters. Off to the side of the entry you see a wall. The Starboard Deck is to the east, the Port Deck is to the West, the bow is to the north, and the Cargo Hold is below you.

You can see Entry here.

>s
(first opening Entry)
It seems to be locked.

>n
Bow of the Ship
The Center deck is to the south.

You can see Seamus here.

>s
Center Deck
As you stand in the center deck you catch the scent of bread coming from the south, the Captain's Quarters. The entry door leads to the Captain's Quarters. Off to the side of the entry you see a wall. The Starboard Deck is to the east, the Port Deck is to the West, the bow is to the north, and the Cargo Hold is below you.

You can see Entry here.

>w
Port Deck
The Center deck is to the east.

You can see dinghy boat (empty) here.

* * *

>n
(first opening the Jail Door)
It seems to be locked.

>break floorboards
Violence isn't the answer to this one.

>break floorboard
Violence isn't the answer to this one.

>x door
A door with metal bars keeping you caged in the holding cell. This is your only way out. It is old and rusty from the ocean's salt water. It is very weak and could possibly be pried open.

>pry open the door
What do you want to pry open the Jail Door with?

>take floorboard
Taken.

>pry open jail door
(with loose floorboard)
you break open the jail door. North towards the cargo hold is the only way you can go.

>n
Cargo Hold
A room where there is pirate clothing and other cargo. The Holding Cell is to the south and the Crew's Quarters are to the north. Be careful though, I wouldn't recommend going into the Crew's quarters... you don't look like a pirate at all. If you want to go up, there is a small ladder you can climb to the Center Deck.

You can see a Jail Door, eyepatch and pirate coat here.

>take all
eyepatch: Taken.
pirate coat: Taken.

>wear eye patch
You can't see any such thing.

>wear eyepatch
You put on eyepatch.

>wear coat
You put on pirate coat.

>climb
What do you want to climb?

>ladder
You can't see any such thing.

>up
Center Deck
As you stand in the center deck you catch the scent of bread coming from the south, the Captain's Quarters. The entry door leads to the Captain's Quarters. Off to the side of the entry you see a wall. The Starboard Deck is to the east, the Port Deck is to the West, the bow is to the north, and the Cargo Hold is below you.

You can see Entry here.

>x wall
a wall that leads to the roof of the Captain's Quarters if you can manage to climb it.

>e
Starboard Deck
The Center deck is to the west.

You can see wooden oars here.

>take all
wooden oars: Taken.

>w
Center Deck
As you stand in the center deck you catch the scent of bread coming from the south, the Captain's Quarters. The entry door leads to the Captain's Quarters. Off to the side of the entry you see a wall. The Starboard Deck is to the east, the Port Deck is to the West, the bow is to the north, and the Cargo Hold is below you.

You can see Entry here.

>w
Port Deck
The Center deck is to the east.

You can see dinghy boat (empty) here.

>take boat
That's fixed in place.

>x boat
a watercraft that you can possibly use to escape from the pirate ship.

>e
Center Deck
As you stand in the center deck you catch the scent of bread coming from the south, the Captain's Quarters. The entry door leads to the Captain's Quarters. Off to the side of the entry you see a wall. The Starboard Deck is to the east, the Port Deck is to the West, the bow is to the north, and the Cargo Hold is below you.

You can see Entry here.

>n
Bow of the Ship
The Center deck is to the south.

You can see Seamus here.

>talk to seamus
"Hi there. How are you?" you say confidently. 

"Not too good. I'm really hungry." he complains. 

"Are you looking for some food?" you inquire. 

"I'm starving mate. If you have any food, I'd be willing to trade you my knife for it."

>s
Center Deck
As you stand in the center deck you catch the scent of bread coming from the south, the Captain's Quarters. The entry door leads to the Captain's Quarters. Off to the side of the entry you see a wall. The Starboard Deck is to the east, the Port Deck is to the West, the bow is to the north, and the Cargo Hold is below you.

You can see Entry here.

>s
(first opening Entry)
It seems to be locked.

>x entry
A large wooden door with intricate designs of skulls and crossbones. It is locked shut. There must be another way to get into the Captain's Quarters.

>down
Cargo Hold
A room where there is pirate clothing and other cargo. The Holding Cell is to the south and the Crew's Quarters are to the north. Be careful though, I wouldn't recommend going into the Crew's quarters... you don't look like a pirate at all. If you want to go up, there is a small ladder you can climb to the Center Deck.

You can see a Jail Door here.

>n
Crew's Quarters
This is the place where the pirates sleep at night and relax when they can. The Cargo Hold is to the south.

You can see rope and hooking claw here.

you were able to sneak into the Crew's Quarters unnoticed.

>take all
rope: Taken.
hooking claw: Taken.

you were able to sneak into the Crew's Quarters unnoticed.

>s
Cargo Hold
A room where there is pirate clothing and other cargo. The Holding Cell is to the south and the Crew's Quarters are to the north. Be careful though, I wouldn't recommend going into the Crew's quarters... you don't look like a pirate at all. If you want to go up, there is a small ladder you can climb to the Center Deck.

You can see a Jail Door here.

>up
Center Deck
As you stand in the center deck you catch the scent of bread coming from the south, the Captain's Quarters. The entry door leads to the Captain's Quarters. Off to the side of the entry you see a wall. The Starboard Deck is to the east, the Port Deck is to the West, the bow is to the north, and the Cargo Hold is below you.

You can see Entry here.

>i
You are carrying:
  hooking claw
  rope
  wooden oars
  pirate coat (being worn)
  eyepatch (being worn)
  loose floorboard

>combine claw with rope
you now have a grappling hook.

>throw grappling hook
Dropped.

>pick up grappling hook
Taken.

>x
What do you want to examine?

>look at the wall
a wall that leads to the roof of the Captain's Quarters if you can manage to climb it.

>climb wall
You use the grappling hook to scale down the wall.

roof
You are now above the Captain's Quarters and there is an open hatch that you can go down. From up here you can also climb the wall back down to the Center Deck.

>open hatch
You can't see any such thing.

>d
Captain's Quarters
The place where the Captain lives when he is not on the deck bossing his crew around.

You can see Entry and bread here.

>up
roof
You are now above the Captain's Quarters and there is an open hatch that you can go down. From up here you can also climb the wall back down to the Center Deck.

>down
Captain's Quarters
The place where the Captain lives when he is not on the deck bossing his crew around.

You can see Entry and bread here.

>take bread
Taken.

>u
roof
You are now above the Captain's Quarters and there is an open hatch that you can go down. From up here you can also climb the wall back down to the Center Deck.

>climb down
You must name something more substantial.

>down
Captain's Quarters
The place where the Captain lives when he is not on the deck bossing his crew around.

You can see Entry here.

>exit
But you aren't in anything at the moment.

>x entry
A large wooden door with intricate designs of skulls and crossbones. It is locked shut. There must be another way to get into the Captain's Quarters.

>up
roof
You are now above the Captain's Quarters and there is an open hatch that you can go down. From up here you can also climb the wall back down to the Center Deck.

>climb wall
You can't see any such thing.

>climb down wall
I only understood you as far as wanting to climb down.

>climb down the wall
I only understood you as far as wanting to climb down.

>climb wall
You can't see any such thing.

>take wall
You can't see any such thing.

>climb wall
You can't see any such thing.

>d
Captain's Quarters
The place where the Captain lives when he is not on the deck bossing his crew around.

You can see Entry here.

>n
(first opening Entry)
It seems to be locked.

>u
roof
You are now above the Captain's Quarters and there is an open hatch that you can go down. From up here you can also climb the wall back down to the Center Deck.

>d
Captain's Quarters
The place where the Captain lives when he is not on the deck bossing his crew around.

You can see Entry here.

>i
You are carrying:
  bread
  grappling hook
  hooking claw
  rope
  wooden oars
  pirate coat (being worn)
  eyepatch (being worn)
  loose floorboard

>s
You can't go that way.

>u
roof
You are now above the Captain's Quarters and there is an open hatch that you can go down. From up here you can also climb the wall back down to the Center Deck.

>i
You are carrying:
  bread
  grappling hook
  hooking claw
  rope
  wooden oars
  pirate coat (being worn)
  eyepatch (being worn)
  loose floorboard

* * *

>n
(first opening the Jail Door)
It seems to be locked.

>take floorboard
Taken.

>pry door with floorboard
you break open the jail door. North towards the cargo hold is the only way you can go.

>n
Cargo Hold
You can see a Jail Door, eyepatch and pirate coat here.

>n
Crew's Quarters
You can see rope and hooking claw here.

>take all
rope: Taken.
hooking claw: Taken.

>combine rope with claw
you now have a grappling hook.

>s
Cargo Hold
You can see a Jail Door here.

>u
Center Deck

* * *

>open jail door
It seems to be locked.

>unlock the jaildoor
You can't see any such thing.

>see jail door
That's not a verb I recognise.

>x door
A door with metal bars keeping you caged in the holding cell. This is your only way out. It is old and rusty from the ocean's salt water. It is very weak and could possibly be pried open.

>pry open door
What do you want to pry open the Jail Door with?

>pry open doorfloor board
You can't see any such thing.

>pry open door floor board
You can't see any such thing.

>pry open door with floor board
You can't see any such thing.

>pry open door
What do you want to pry open the Jail Door with?

>floorboard
you break open the jail door. North towards the cargo hold is the only way you can go.

>n
Cargo Hold
A room where there is pirate clothing and other cargo. The Holding Cell is to the south and the Crew's Quarters are to the north. Be careful though, I wouldn't recommend going into the Crew's quarters... you don't look like a pirate at all. If you want to go up, there is a small ladder you can climb to the Center Deck.

You can see a Jail Door, eyepatch and pirate coat here.

>xcenter deck
That's not a verb I recognise.

>up
Center Deck
As you stand in the center deck you catch the scent of bread coming from the south, the Captain's Quarters. The entry door leads to the Captain's Quarters. Off to the side of the entry you see a wall. The Starboard Deck is to the east, the Port Deck is to the West, the bow is to the north, and the Cargo Hold is below you.

You can see Entry here.

>n
Bow of the Ship
The Center deck is to the south.

You can see Seamus here.

* * *

>s
Center Deck
As you stand in the center deck you catch the scent of bread coming from the south, the Captain's Quarters. The entry door leads to the Captain's Quarters. Off to the side of the entry you see a wall. The Starboard Deck is to the east, the Port Deck is to the West, the bow is to the north, and the Cargo Hold is below you.

You can see Entry here.

>n
Bow of the Ship
The Center deck is to the south.

You can see Seamus here.

>talk to Seamsu
You can't see any such thing.

>talk to Seamus
"Hi there. How are you?" you say confidently. 

"Not too good. I'm really hungry." he complains. 

"Are you looking for some food?" you inquire. 

"I'm starving mate. If you have any food, I'd be willing to trade you my knife for it."

>trade with seamus
That's not a verb I recognise.

>s
Center Deck
As you stand in the center deck you catch the scent of bread coming from the south, the Captain's Quarters. The entry door leads to the Captain's Quarters. Off to the side of the entry you see a wall. The Starboard Deck is to the east, the Port Deck is to the West, the bow is to the north, and the Cargo Hold is below you.

You can see Entry here.

>e
Starboard Deck
The Center deck is to the west.

You can see wooden oars here.

>w
Center Deck
As you stand in the center deck you catch the scent of bread coming from the south, the Captain's Quarters. The entry door leads to the Captain's Quarters. Off to the side of the entry you see a wall. The Starboard Deck is to the east, the Port Deck is to the West, the bow is to the north, and the Cargo Hold is below you.

You can see Entry here.

>d
Cargo Hold
A room where there is pirate clothing and other cargo. The Holding Cell is to the south and the Crew's Quarters are to the north. Be careful though, I wouldn't recommend going into the Crew's quarters... you don't look like a pirate at all. If you want to go up, there is a small ladder you can climb to the Center Deck.

You can see a Jail Door, eyepatch and pirate coat here.

>put on eyepatch
(first taking eyepatch)
You put on eyepatch.

>put on coat
(first taking pirate coat)
You put on pirate coat.

>n
Crew's Quarters
This is the place where the pirates sleep at night and relax when they can. The Cargo Hold is to the south.

You can see rope and hooking claw here.

you were able to sneak into the Crew's Quarters unnoticed.

* * *

>take all
rope: Taken.
hooking claw: Taken.

you were able to sneak into the Crew's Quarters unnoticed.

>combine rope with clW
You can't see any such thing.

>combine rope with claw
you now have a grappling hook.

you were able to sneak into the Crew's Quarters unnoticed.

>s up
I only understood you as far as wanting to (go) s.

>up
You can't go that way.

you were able to sneak into the Crew's Quarters unnoticed.

>s
Cargo Hold
A room where there is pirate clothing and other cargo. The Holding Cell is to the south and the Crew's Quarters are to the north. Be careful though, I wouldn't recommend going into the Crew's quarters... you don't look like a pirate at all. If you want to go up, there is a small ladder you can climb to the Center Deck.

You can see a Jail Door here.

>u
Center Deck
As you stand in the center deck you catch the scent of bread coming from the south, the Captain's Quarters. The entry door leads to the Captain's Quarters. Off to the side of the entry you see a wall. The Starboard Deck is to the east, the Port Deck is to the West, the bow is to the north, and the Cargo Hold is below you.

You can see Entry here.

* * *

>s
(first opening Entry)
It seems to be locked.

>u
You use the hook to climb up to the roof.

roof
You are now above the Captain's Quarters and there is an open hatch that you can go down. From up here you can also scale down to get back down down to the Center Deck.

>d
Captain's Quarters
The place where the Captain lives when he is not on the deck bossing his crew around.

You can see Entry and bread here.

>take breas
You can't see any such thing.

>take bread
Taken.

>u
roof
You are now above the Captain's Quarters and there is an open hatch that you can go down. From up here you can also scale down to get back down down to the Center Deck.

>d
You use the hook to scale the wall down to the ground.

Center Deck
As you stand in the center deck you catch the scent of bread coming from the south, the Captain's Quarters. The entry door leads to the Captain's Quarters. Off to the side of the entry you see a wall. The Starboard Deck is to the east, the Port Deck is to the West, the bow is to the north, and the Cargo Hold is below you.

You can see Entry here.

>n
Bow of the Ship
The Center deck is to the south.

You can see Seamus here.

>give bread
(to Seamus)
Seamus is pleased. He gives you the knife.

>take knife
You already have that.

>i
You are carrying:
  a knife
  bread
  grappling hook
  hooking claw
  rope
  pirate coat (being worn)
  eyepatch (being worn)

>s
Center Deck
As you stand in the center deck you catch the scent of bread coming from the south, the Captain's Quarters. The entry door leads to the Captain's Quarters. Off to the side of the entry you see a wall. The Starboard Deck is to the east, the Port Deck is to the West, the bow is to the north, and the Cargo Hold is below you.

You can see Entry here.

* * *

>e
Starboard Deck
The Center deck is to the west.

You can see wooden oars here.

>take wooden oars
Taken.

>w
Center Deck
As you stand in the center deck you catch the scent of bread coming from the south, the Captain's Quarters. The entry door leads to the Captain's Quarters. Off to the side of the entry you see a wall. The Starboard Deck is to the east, the Port Deck is to the West, the bow is to the north, and the Cargo Hold is below you.

You can see Entry here.

* * *

>take boat
That's fixed in place.

>use knife
That's not a verb I recognise.

>cut with knife
You can't see any such thing.

>cut straps
Cutting it up would achieve little.

>cut straps with knife
try connecting the oars to the dinghy boat first.

>connect oars
What do you want to connect wooden oars to?

>boat
you attach the wooden oars to the dinghy boat

>cut straps
Cutting it up would achieve little.

>cut straps with knife
the boat drops down into the water. Jump in the dinghy boat before it floats away.

>jump in boat
Now that the oars are attached to the dinghy boat. Try lowering it into the ocean.

    *** You jump off the edge of the ship and land hardly in the boat. You escaped the pirate ship! You win! ***

Would you like to RESTART, RESTORE a saved game, QUIT or UNDO the last command?

* * *

>pry jail door
What do you want to pry the Jail Door with?

>floorboard
you are going to need something to help you to pry open the jail door.

* * *

>pry open door with floorboard
you break open the jail door. North towards the cargo hold is the only way you can go.

* * *

>pry open jail door with floorboard
you are going to need something to help you to pry open the jail door.

>break floorboard
Violence isn't the answer to this one.

>break off floorboard
you manage to break off the loose floorboard. Maybe it can help you to get out of the holding cell.

>take all
C'mon now, you really thought it would be that easy?

* * *

>take all
C'mon now, you really thought it would be that easy?

>pry door with floorboard
you break open the jail door. North towards the cargo hold is the only way you can go.

>n
Cargo Hold
A room where there is pirate clothing and other cargo. The Holding Cell is to the south and the Crew's Quarters are to the north. Be careful though, I wouldn't recommend going into the Crew's quarters... you don't look like a pirate at all. If you want to go up, there is a small ladder you can climb to the Center Deck.

You can see a Jail Door, eyepatch and pirate coat here.

>put on all
(loose floorboard)
You can't wear that!

>put on pirate coat
(first taking pirate coat)
You put on pirate coat.

>put on eyepatch
(first taking eyepatch)
You put on eyepatch.

>n
Crew's Quarters
You can see rope and hooking claw here.

you were able to sneak into the Crew's Quarters unnoticed.

>take all
rope: Taken.
hooking claw: Taken.

you were able to sneak into the Crew's Quarters unnoticed.

>combine claw with rope
you now have a grappling hook.

you were able to sneak into the Crew's Quarters unnoticed.

I beg your pardon?

>s
Cargo Hold
You can see a Jail Door here.

* * *

>climb down wall
I only understood you as far as wanting to climb down.

>climb down wall
I only understood you as far as wanting to climb down.

>undo
Center Deck
[Previous turn undone.]

>undo
Center Deck
[Previous turn undone.]

* * *

>scale down wall
I only understood you as far as wanting to scale down.

* * *

>n
Cargo Hold
A room where there is pirate clothing and other cargo. The Holding Cell is to the south and the Crew's Quarters are to the north. Be careful though, I wouldn't recommend going into the Crew's quarters... you don't look like a pirate at all. If you want to go up, there is a small ladder you can climb to the Center Deck.

You can see a Jail Door, eyepatch and pirate coat here.

>put on eyepatch
(first taking eyepatch)
You put on eyepatch.

* * *

>put on coat
(first taking pirate coat)
You put on pirate coat.

>n
Crew's Quarters
You can see rope and hooking claw here.

you were able to sneak into the Crew's Quarters unnoticed.

* * *

>combine claw with rope
you now have a grappling hook.

you were able to sneak into the Crew's Quarters unnoticed.

>s
Cargo Hold
You can see a Jail Door here.

* * *

>u
Center Deck

>climb up wall
You throw the grappling claw and it hooks onto the roof. You climb the rope.

roof

>climb wall
You can't see any such thing.

>undo
roof
[Previous turn undone.]

>undo
Center Deck
[Previous turn undone.]

>climb wall
You throw the grappling claw and it hooks onto the roof. You climb the rope.

roof

>climb wall
You can't see any such thing.

>d
Captain's Quarters
You can see bread here.

>u
roof

>d
Captain's Quarters
You can see bread here.

>take all
bread: Taken.

>u
roof

>climb wall
You can't see any such thing.

>climb wall
You can't see any such thing.

* * *

>take all
rope: Taken.
hooking claw: Taken.

you were able to sneak into the Crew's Quarters unnoticed.

>combine rope with claw
you now have a grappling hook.

you were able to sneak into the Crew's Quarters unnoticed.

>s
Cargo Hold
You can see a Jail Door here.

* * *

>u
Center Deck

>climb wall
You throw the grappling claw and it hooks onto the roof. You climb the rope.

roof

* * *

>climb wall
You can't see any such thing.

>climb up wall
You can't see any such thing.

* * *

>put on eyepatch
(first taking eyepatch)
You put on eyepatch.

>put on pirate coat
(first taking pirate coat)
You put on pirate coat.

>n
Crew's Quarters
You can see rope and hooking claw here.

you were able to sneak into the Crew's Quarters unnoticed.

* * *

>put on eyepatch
(first taking eyepatch)
You put on eyepatch.

>take off eye patch
You can't see any such thing.

>take off eyepatch
You take off eyepatch.

>n
Crew's Quarters
You can see rope and hooking claw here.

    *** A pirate noticed you and you were caught. You Lose. ***

Would you like to RESTART, RESTORE a saved game, QUIT or UNDO the last command?

>undo
Cargo Hold
[Previous turn undone.]

>put on eyepatch
You put on eyepatch.

>n
Crew's Quarters
You can see rope and hooking claw here.

    *** A pirate noticed you and you were caught. You Lose. ***

Would you like to RESTART, RESTORE a saved game, QUIT or UNDO the last command?

* * *

>undo
Cargo Hold
[Previous turn undone.]

>put on eyepatch
You're already wearing that!

>put on pirate coat
(first taking pirate coat)
You put on pirate coat.

* * *

>n
Crew's Quarters
You can see rope and hooking claw here.

you were able to sneak into the Crew's Quarters unnoticed.

>restart
Are you sure you want to restart?

Please answer yes or no.

>y
You are a British sailor who is being held captive on a pirate ship. Tomorrow you are supposed to walk the plank. It is night time and most of the pirates are asleep, this is your only chance to get off of the pirate ship and make it out alive. However, you also know the Captain has treasure he took from you. If you take back your treasure and escape the ship with your life you will be a legend amongst your British sailors. Good luck!

Pirate Ship Escape
An Interactive Fiction by ggrune20
Release 1 / Serial number 190411 / Inform 7 build 6M62 (I6/v6.33 lib 6/12N) SD

Holding Cell
You can see a Jail Door and loose floorboard here.

>take floorboard
Taken.

* * *

>n
Cargo Hold
You can see a Jail Door, eyepatch and pirate coat here.

>n
Crew's Quarters
You can see rope and hooking claw here.

    *** A pirate noticed you and you were caught. You Lose. ***

Would you like to RESTART, RESTORE a saved game, QUIT or UNDO the last command?

* * *

>undo
Cargo Hold
[Previous turn undone.]

>u
Center Deck

>s
Captain's Quarters
You can see bread here.

>n
Center Deck

>d
Cargo Hold
You can see a Jail Door, eyepatch and pirate coat here.

>n
Crew's Quarters
You can see rope and hooking claw here.

    *** A pirate noticed you and you were caught. You Lose. ***

Would you like to RESTART, RESTORE a saved game, QUIT or UNDO the last command?

* * *

>undo
Cargo Hold
[Previous turn undone.]

>put on all
(loose floorboard)
You can't wear that!

>put on eye patch
You can't see any such thing.

>put on eyepatch
(first taking eyepatch)
You put on eyepatch.

* * *

>u
Center Deck
As you stand in the center deck you catch the scent of bread coming from the south, the Captain's Quarters. The entry door leads to the Captain's Quarters. Off to the side of the entry you see a wall. The Starboard Deck is to the east, the Port Deck is to the West, the bow is to the north, and the Cargo Hold is below you.

You can see Entry here.

>d
Cargo Hold
A room wear there is pirate clothing and other cargo.

You can see a Jail Door, eyepatch and pirate coat here.

>put on eyepatch
(first taking eyepatch)
You put on eyepatch.

* * *

>u
Center Deck
As you stand in the center deck you catch the scent of bread coming from the south, the Captain's Quarters. The entry door leads to the Captain's Quarters. Off to the side of the entry you see a wall. The Starboard Deck is to the east, the Port Deck is to the West, the bow is to the north, and the Cargo Hold is below you.

You can see Entry here.

>n
Bow of the Ship
The Center deck is to the south.

You can see Seamus here.

* * *

>talk to seamus
"Hi there. How are you?" you say confidently. 

"Not too good. I'm really hungry." he complains. 

"Are you looking for some food?" you inquire. 

"I'm starving mate. If you have any food, I'd be willing to trade you my knife for it."

>ask seamus about knife
"This knife can cut anything lad", a rope, a strap, you name it. I'd given the captain this knife for the food in his quarters any day but he doesn't need no knife." says Seamus.

>ask seamus about food
"The Captain barely feeds us. I know he has food in his quarters but I'm not allowed in there. I'm just the cabin boy." Seamus responds.

* * *

>take all
C'mon now, you really thought it would be that easy?

>pry open door
What do you want to pry open the Jail Door with?

>n
Cargo Hold
A room where there is pirate clothing and other cargo. The Holding Cell is to the south and the Crew's Quarters are to the north. Be careful though, I wouldn't recommend going into the Crew's quarters... you don't look like a pirate at all. If you want to go up, there is a small ladder you can climb to the Center Deck.

You can see a Jail Door, eyepatch and pirate coat here.

* * *

>combine claw with rope
you now have a grappling hook.

you were able to sneak into the Crew's Quarters unnoticed.

>s
Cargo Hold
A room where there is pirate clothing and other cargo. The Holding Cell is to the south and the Crew's Quarters are to the north. Be careful though, I wouldn't recommend going into the Crew's quarters... you don't look like a pirate at all. If you want to go up, there is a small ladder you can climb to the Center Deck.

You can see a Jail Door here.

* * *

>u
Center Deck
As you stand in the center deck you catch the scent of bread coming from the south, the Captain's Quarters. The entry door leads to the Captain's Quarters. Off to the side of the entry you see a wall. The Starboard Deck is to the east, the Port Deck is to the West, the bow is to the north, and the Cargo Hold is below you.

You can see Entry here.

>climb wall
You throw the grappling claw and it hooks onto the roof. You climb the rope.

roof
You are now above the Captain's Quarters and there is an open hatch that you can go down. From up here you can also climb the wall back down to the Center Deck.

>climb wall
You can't see any such thing.

>d
Captain's Quarters
The place where the Captain lives when he is not on the deck bossing his crew around.

You can see Entry and bread here.

>u
roof
You are now above the Captain's Quarters and there is an open hatch that you can go down. From up here you can also climb the wall back down to the Center Deck.

>climb wall
You can't see any such thing.

* * *

>pry open door
What do you want to pry open the Jail Door with?

>with floorboard
You can't see any such thing.

>pry open door with floorboard
you break open the jail door. North towards the cargo hold is the only way you can go.

* * *

>take all
C'mon now, you really thought it would be that easy?

>pry open door with floorboard
you break open the jail door. North towards the cargo hold is the only way you can go.

* * *

>s
(first opening Entry)
It seems to be locked.

>s
(first opening Entry)
It seems to be locked.

>x wall
a wall that leads to the roof of the Captain's Quarters if you can manage to climb it.

>climb wall
You use the grappling hook to scale down the wall.

roof

* * *

>put on pirate coat
(first taking pirate coat)
You put on pirate coat.

>n
Crew's Quarters
This is the place where the pirates sleep at night and relax when they can. The Cargo Hold is to the south.

You can see rope and hooking claw here.

you were able to sneak into the Crew's Quarters unnoticed.

* * *

>u
Center Deck
As you stand in the center deck you catch the scent of bread coming from the south, the Captain's Quarters. The entry door leads to the Captain's Quarters. Off to the side of the entry you see a wall. The Starboard Deck is to the east, the Port Deck is to the West, the bow is to the north, and the Cargo Hold is below you.

You can see Entry here.

>climb wall
You throw the grappling claw and it hooks onto the roof. You climb the rope.

roof
You are now above the Captain's Quarters and there is an open hatch that you can go down. From up here you can also scale down to get back down down to the Center Deck.

>scale wall
You can't see any such thing.

>scale down
You must name something more substantial.

>scale down roof
I only understood you as far as wanting to scale down.

>d
Captain's Quarters
The place where the Captain lives when he is not on the deck bossing his crew around.

You can see Entry and bread here.

>take bread
Taken.

* * *

>n
Bow of the Ship
The Center deck is to the south.

You can see Seamus here.

>x seamus
the cabin boy. His stomach is growling and he is clearly very hungry.

>talk to seamus
"Hi there. How are you?" you say confidently. 

"Not too good. I'm really hungry." he complains. 

"Are you looking for some food?" you inquire. 

"I'm starving mate. If you have any food, I'd be willing to trade you my knife for it."

>ask about food
You can't see any such thing.

>ask about food
You can't see any such thing.

* * *

>pry open door with floorboard
you break open the jail door. North towards the cargo hold is the only way you can go.

>pry door with floorboard
you break open the jail door. North towards the cargo hold is the only way you can go.

* * *

>n
Cargo Hold
You can see a Jail Door, eyepatch and pirate coat here.

>put on eyepatch
(first taking eyepatch)
You put on eyepatch.

* * *

>take all
rope: Taken.
hooking claw: Taken.

you were able to sneak into the Crew's Quarters unnoticed.

>s
Cargo Hold
You can see a Jail Door here.

* * *

>n
Center Deck

>combine claw with rope
you now have a grappling hook.

>u
You use the hook to climb up to the roof.

roof

>d
You use the hook to climb down to the ground.

Center Deck

* * *

>take all
C'mon now, you really thought it would be that easy?

>pry open jail door with floorboar
you break open the jail door. North towards the cargo hold is the only way you can go.

>pry open jail door with floorboard
you break open the jail door. North towards the cargo hold is the only way you can go.

>undo
Holding Cell
[Previous turn undone.]

>undo
Holding Cell
[Previous turn undone.]

>pry jail door
(with loose floorboard)
you break open the jail door. North towards the cargo hold is the only way you can go.

>n
Cargo Hold
A room where there is pirate clothing and other cargo. The Holding Cell is to the south and the Crew's Quarters are to the north. Be careful though, I wouldn't recommend going into the Crew's quarters... you don't look like a pirate at all. If you want to go up, there is a small ladder you can climb to the Center Deck.

You can see a Jail Door, eyepatch and pirate coat here.

* * *

>u
Center Deck
As you stand in the center deck you catch the scent of bread coming from the south, the Captain's Quarters. The entry door leads to the Captain's Quarters. Off to the side of the entry you see a wall. The Starboard Deck is to the east, the Port Deck is to the West, the bow is to the north, and the Cargo Hold is below you.

You can see Entry here.

>climb wall
You use the grappling hook to scale down the wall.

roof
You are now above the Captain's Quarters and there is an open hatch that you can go down. From up here you can also climb the wall back down to the Center Deck.

>climb wall
You can't see any such thing.

* * *

>take all
C'mon now, you really thought it would be that easy?

>take floorboard
You manage to break off the loose floorboard. Maybe it can help you to get out of the holding cell.

>pry open door with floorboard
you break open the jail door. North towards the cargo hold is the only way you can go.

>n
Cargo Hold
A room where there is pirate clothing and other cargo. The Holding Cell is to the south and the Crew's Quarters are to the north. Be careful though, I wouldn't recommend going into the Crew's quarters... you don't look like a pirate at all. If you want to go up, there is a small ladder you can climb to the Center Deck.

You can see a Jail Door and Wooden Chest (in which are eyepatch and pirate coat) here.

* * *

>take floorboard
You manage to break off the loose floorboard. Maybe it can help you to get out of the holding cell.

>break open jail door with floorboard
you break open the jail door. North towards the cargo hold is the only way you can go.

* * *

>take floorboard
You manage to break off the loose floorboard. Maybe it can help you to get out of the holding cell.

>n
(first opening the Jail Door)
It seems to be locked.

>pry door with floorboard
you break open the jail door. North towards the cargo hold is the only way you can go.

>n
Cargo Hold
You can see a Jail Door here.

>u
Center Deck

>w
Port Deck
You can see dinghy boat (empty) here.

>jump in dinghy boat
You should drop the dinghy boat into the ocean before you get into it.

>e
Center Deck

>s
Captain's Quarters
You can see bread here.

>take bread
Taken.

>n
Center Deck

>n
Bow of the Ship
You can see Seamus here.

>give bread to seamus
Seamus is pleased. He gives you the knife.

I beg your pardon?

>s
Center Deck

>e
Starboard Deck
You can see wooden oars here.

>take oars
Taken.

>w
Center Deck

>w
Port Deck
You can see dinghy boat (empty) here.

>cut rope
Cutting it up would achieve little.

>cut rope with knife
the boat drops down into the water. Jump in the dinghy boat before it floats away.

* * *

>attach wooden oars to dinghy boat
You would achieve nothing by this.

>put wooden oars on dinghy boat
Putting things on dinghy boat would achieve nothing.

* * *

>undo
Port Deck
[Previous turn undone.]

>undo
Port Deck
[Previous turn undone.]

>n
You can't go that way.

>give seamus bread
You can't see any such thing.

>s
You can't go that way.

>w
You can't go that way.

>e
Center Deck

>e
Starboard Deck

>take oars
You already have that.

>w
Center Deck

* * *

>w
Port Deck
You can see dinghy boat (empty) here.

>put oars on boat
Putting things on dinghy boat would achieve nothing.

>jump in dinghy boat
You should drop the dinghy boat into the ocean before you get into it.

>cut rope with knife
the boat drops down into the water. Jump in the dinghy boat before it floats away.

* * *

>take floorboard
You manage to break off the loose floorboard. Maybe it can help you to get out of the holding cell.

>open door
It seems to be locked.

>s
You can't go that way.

>n
(first opening the Jail Door)
It seems to be locked.

>pry door with floorboard
you break open the jail door.

>n
Cargo Hold
You can see a Jail Door here.

* * *

>take floorboard
You manage to break off the loose floorboard. Maybe it can help you to get out of the holding cell.

>pry door with board
You can't see any such thing.

>pry door with floorboard
you break open the jail door. North towards the cargo hold is the only way you can go.

* * *

>s
Captain's Quarters
You can see bread here.

>take
(bread)
Taken.

>n
Center Deck

* * *

>give bread to seamus
Seamus is pleased. He gives you the knife.

>s
Center Deck

>w
Port Deck
You can see dinghy boat (empty) here.

>cut rope with knife
the boat drops down into the water. Jump in the dinghy boat before it floats away.

* * *

I beg your pardon?

I beg your pardon?

* * *

>take floorboard
You manage to break off the loose floorboard. Maybe it can help you to get out of the holding cell.

>pry door with floorboard
you break open the jail door. North towards the cargo hold is the only way you can go.

* * *

>n
Cargo Hold
A room where there is pirate clothing and other cargo. The Holding Cell is to the south and the Crew's Quarters are to the north. Be careful though, I wouldn't recommend going into the Crew's quarters... you don't look like a pirate at all. If you want to go up, there is a small ladder you can climb to the Center Deck.

You can see a Jail Door, eyepatch and pirate coat here.

>n
Crew's Quarters
You can see rope and hooking claw here.

* * *

>u
Center Deck

>use hook
That's not a verb I recognise.

* * *

>take all
rope: Taken.
hooking claw: Taken.

>s
Cargo Hold
You can see a Jail Door here.

* * *

>u
Center Deck

>combine rope with claw
you now have a grappling hook.

>s
Captain's Quarters
You can see bread here.

>m
That's not a verb I recognise.

>n
Center Deck

>u
roof

* * *

>d
Captain's Quarters
You can see bread here.

>take bread
Taken.

>s
You can't go that way.

>n
Center Deck

* * *

>w
Port Deck
You can see dinghy boat (empty) here.

>e
Center Deck

>e
Starboard Deck
You can see wooden oars here.

>take all
wooden oars: Taken.

>w
Center Deck

* * *

>w
Port Deck
You can see dinghy boat (empty) here.

>jump in boat
You should drop the dinghy boat into the ocean before you get into it.

>cut rope
Cutting it up would achieve little.

>cut straps
Cutting it up would achieve little.

* * *

>connect oars to boat
you attach the wooden oars to the dinghy boat

>cut straps
Cutting it up would achieve little.

* * *

>cut straps with knife
the boat drops down into the water. Jump in the dinghy boat before it floats away.

>undo
Port Deck
[Previous turn undone.]

>cut straps with knife
try connecting the oars to the dinghy boat first.

>connect oars to boat
you attach the wooden oars to the dinghy boat

>enter boat
Now that the oars are attached to the dinghy boat. Try lowering it into the ocean.

>cut straps with knife
the boat drops down into the water. Jump in the dinghy boat before it floats away.

* * *

>n
Crew's Quarters
You can see rope and hooking claw here.

>take rope
Taken.

>take all
hooking claw: Taken.

>combine rope and claw
You can't use multiple objects with that verb.

>combine rope with claw
you now have a grappling hook.

* * *

>n
Center Deck

>up
roof

>use grappling hook
That's not a verb I recognise.

* * *

>put on eyepatch
(first taking eyepatch)
You put on eyepatch.

>n
Crew's Quarters
You can see rope and hooking claw here.

    *** A pirate noticed you and you were caught. You Lose. ***

Would you like to RESTART, RESTORE a saved game, QUIT or UNDO the last command?

* * *

>undo
Cargo Hold
[Previous turn undone.]

>take off eyepatch
You take off eyepatch.

>put on pirate coat
(first taking pirate coat)
You put on pirate coat.

>n
Crew's Quarters
You can see rope and hooking claw here.

    *** A pirate noticed you and you were caught. You Lose. ***

Would you like to RESTART, RESTORE a saved game, QUIT or UNDO the last command?

* * *

>put on eyepatch
You put on eyepatch.

>put on pirate coat
You're already wearing that!

>n
Crew's Quarters
You can see rope and hooking claw here.

you were able to sneak into the Crew's Quarters unnoticed.

* * *

>n
Cargo Hold
A room where there is pirate clothing and other cargo. The Holding Cell is to the south and the Crew's Quarters are to the north. Be careful though, I wouldn't recommend going into the Crew's quarters... you don't look like a pirate at all. If you want to go up, there is a small ladder you can climb to the Center Deck.

You can see a Jail Door, eyepatch and pirate coat here.

>u
Center Deck

>e
Starboard Deck
You can see wooden oars here.

* * *

>w
Center Deck

>s
Captain's Quarters
You can see bread here.

* * *

>n
Bow of the Ship
You can see Seamus here.

>give seamus bread
Seamus is pleased. He gives you the knife.

>s
Center Deck

* * *

>jump in boat
You should drop the dinghy boat into the ocean before you get into it.

>attach wooden oars to boat
You would achieve nothing by this.

>attach wooden oars to dinghy boat
You would achieve nothing by this.

>attach wooden oars to dinghy boat
You would achieve nothing by this.

>attach oars to boat
You would achieve nothing by this.

>cut rope
Cutting it up would achieve little.

* * *

>cut rope with knife
the boat drops down into the water. Jump in the dinghy boat before it floats away.

>jump in dinghy boat
    *** you jump off the edge of the ship and land hardly in the boat. You escaped the pirate ship! You win! ***

Would you like to RESTART, RESTORE a saved game, QUIT or UNDO the last command?

>jump in dinghy boat
Please give one of the answers above.

Would you like to RESTART, RESTORE a saved game, QUIT or UNDO the last command?

>enter dinghy boat
Please give one of the answers above.

Would you like to RESTART, RESTORE a saved game, QUIT or UNDO the last command?

* * *

>give bread to seamus
Seamus is pleased. He gives you the knife.

>w
You can't go that way.

>s
Center Deck

* * *

>n
You can't go that way.

>s
You can't go that way.

* * *

>w
You can't go that way.

I beg your pardon?

>e
Center Deck

* * *

>e
Starboard Deck

>e
You can't go that way.

>e
You can't go that way.

>ew
That's not a verb I recognise.

>w
Center Deck

* * *

>w
Port Deck
You can see dinghy boat (empty) here.

>enter dinghy boat
You should drop the dinghy boat into the ocean before you get into it.

>e
Center Deck

* * *

>w
Port Deck
You can see dinghy boat (empty) here.

>pur oars on dinghy boat
That's not a verb I recognise.

>put wooden oars on dinghy boat
you attach the wooden oars to the dinghy boat

* * *

>take floorboard
You manage to break off the loose floorboard. Maybe it can help you to get out of the holding cell.

>pry jail door with floorboard
you break open the jail door. North towards the cargo hold is the only way you can go.

>n
Cargo Hold
You can see a Jail Door here.

* * *

>u
Center Deck

>w
Port Deck
You can see a dinghy boat (empty) here.

>take knife
You can't see any such thing.

>cut rope with knife
You can't see any such thing.

>e
Center Deck

* * *

>n
Bow of the Ship
You can see Seamus here.

>take knife from seamus
That seems to belong to Seamus.

>kill seamus
Violence isn't the answer to this one.

>talk to seamus
That's not a verb I recognise.

>say hi to seamus
There is no reply.

>x seamus
the cabin boy.

>s
Center Deck

>s
Captain's Quarters
You can see bread here.

* * *

>s
Center Deck

>w
Port Deck
You can see a dinghy boat (empty) here.

>cut rope with knife
the boat drops down into the water. Jump in the dinghy boat before it floats away.

* * *

>take floorboard
You manage to break off the loose floorboard. Maybe it can help you to get out of the holding cell.

>pry open door with floorboard
You can't see any such thing.

>pry jail door with floorboard
you break open the jail door. North towards the cargo hold is the only way you can go.

* * *

>e
Starboard Deck
You can see wooden oars here.

>take
(wooden oars)
Taken.

>w
Center Deck

* * *

>w
Port Deck
You can see dinghy boat (empty) here.

>attach wooden oars to dinghy boat
You would achieve nothing by this.

>attach oars
What do you want to attach wooden oars to?

>boat
You would achieve nothing by this.

>attach oars to boat
You would achieve nothing by this.

>attach oars to dinghy boat
You would achieve nothing by this.

>attach oars to dinghy boat
You would achieve nothing by this.

>attach oars to boat
You would achieve nothing by this.

* * *

>take jail door
That's fixed in place.

* * *

>take loose
You can't see any such thing.

>take floorboard
Taken.

* * *

>take plank
You can't see any such thing.

>take plank of wood
You manage to break off the loose floorboard. Maybe it can help you to get out of the holding cell.

* * *

>u
You can't go that way.

>n
Cargo Hold

>u
Center Deck

>w
Port Deck
You can see a Dinghy Boat here.

>take boat
Taken.

>e
Center Deck

>d
Cargo Hold

>n
Crew's Quarters

>u
You can't go that way.

* * *

>x door
You see nothing special about the Jail Door.

>n
(first opening the Jail Door)
It seems to be locked.

>n
(first opening the Jail Door)
It seems to be locked.

* * *

>take floorboard
Taken.

>pry jail door with floorboard
you break open the jail door.

>n
Cargo Hold
You can see a Jail Door here.

* * *

>x floorboard
a two by four plank of hard and very sturdy wood.

>take floorboard
Taken.

>i
You are carrying:
  loose floorboard

>x door
A door with metal bars keeping you caged in the holding cell. This is your only way out. It is old and rusty from the ocean's salt water. It is very weak and could possibly be pried open.

>use floorboard
That's not a verb I recognise.

>pry
(loose floorboard with loose floorboard)

>pry door
(with loose floorboard)
you break open the jail door. North towards the cargo hold is the only way you can go.

>n
Cargo Hold
A room where there is pirate clothing and other cargo. The Holding Cell is to the south and the Crew's Quarters are to the north. Be careful though, I wouldn't recommend going into the Crew's quarters... you don't look like a pirate at all. If you want to go up, there is a small ladder you can climb to the Center Deck.

You can see a Jail Door, eyepatch and pirate coat here.

>up
Center Deck
As you stand in the center deck you catch the scent of bread coming from the south, the Captain's Quarters. The entry door leads to the Captain's Quarters. Off to the side of the entry you see a wall. The Starboard Deck is to the east, the Port Deck is to the West, the bow is to the north, and the Cargo Hold is below you.

You can see Entry here.

>e
Starboard Deck
The Center deck is to the west.

You can see wooden oars here.

>take wooden oar
I only understood you as far as wanting to take wooden oars.

>take oars
Taken.

>w
Center Deck
As you stand in the center deck you catch the scent of bread coming from the south, the Captain's Quarters. The entry door leads to the Captain's Quarters. Off to the side of the entry you see a wall. The Starboard Deck is to the east, the Port Deck is to the West, the bow is to the north, and the Cargo Hold is below you.

You can see Entry here.

>e
Starboard Deck
The Center deck is to the west.

>w
Center Deck
As you stand in the center deck you catch the scent of bread coming from the south, the Captain's Quarters. The entry door leads to the Captain's Quarters. Off to the side of the entry you see a wall. The Starboard Deck is to the east, the Port Deck is to the West, the bow is to the north, and the Cargo Hold is below you.

You can see Entry here.

* * *

>w
Port Deck
The Center deck is to the east.

You can see dinghy boat (empty) here.

>go in dinghy boat
You should drop the dinghy boat into the ocean before you get into it.

>drop dinghy boat
Dinghy boat is already here.

>i
You are carrying:
  wooden oars
  loose floorboard

>w
You can't go that way.

>s
You can't go that way.

>d
You can't go that way.

>a
That's not a verb I recognise.

>a
That's not a verb I recognise.

>w
You can't go that way.

>e
Center Deck
As you stand in the center deck you catch the scent of bread coming from the south, the Captain's Quarters. The entry door leads to the Captain's Quarters. Off to the side of the entry you see a wall. The Starboard Deck is to the east, the Port Deck is to the West, the bow is to the north, and the Cargo Hold is below you.

You can see Entry here.

>w
Port Deck
The Center deck is to the east.

You can see dinghy boat (empty) here.

>e
Center Deck
As you stand in the center deck you catch the scent of bread coming from the south, the Captain's Quarters. The entry door leads to the Captain's Quarters. Off to the side of the entry you see a wall. The Starboard Deck is to the east, the Port Deck is to the West, the bow is to the north, and the Cargo Hold is below you.

You can see Entry here.

>e
Starboard Deck
The Center deck is to the west.

* * *

>w
Center Deck
As you stand in the center deck you catch the scent of bread coming from the south, the Captain's Quarters. The entry door leads to the Captain's Quarters. Off to the side of the entry you see a wall. The Starboard Deck is to the east, the Port Deck is to the West, the bow is to the north, and the Cargo Hold is below you.

You can see Entry here.

>n
Bow of the Ship
The Center deck is to the south.

You can see Seamus here.

>n
You can't go that way.

>push Seamus
Seamus might not like that.

>talk to Seamus
"Hi there. How are you?" you say confidently. 

"Not too good. I'm really hungry." he complains. 

"Are you looking for some food?" you inquire. 

"I'm starving mate. If you have any food, I'd be willing to trade you my knife for it."

>s
Center Deck
As you stand in the center deck you catch the scent of bread coming from the south, the Captain's Quarters. The entry door leads to the Captain's Quarters. Off to the side of the entry you see a wall. The Starboard Deck is to the east, the Port Deck is to the West, the bow is to the north, and the Cargo Hold is below you.

You can see Entry here.

* * *

>s
(first opening Entry)
It seems to be locked.

>w
Port Deck
The Center deck is to the east.

You can see dinghy boat (empty) here.

>s
You can't go that way.

>e
Center Deck
As you stand in the center deck you catch the scent of bread coming from the south, the Captain's Quarters. The entry door leads to the Captain's Quarters. Off to the side of the entry you see a wall. The Starboard Deck is to the east, the Port Deck is to the West, the bow is to the north, and the Cargo Hold is below you.

You can see Entry here.

>down
Cargo Hold
A room where there is pirate clothing and other cargo. The Holding Cell is to the south and the Crew's Quarters are to the north. Be careful though, I wouldn't recommend going into the Crew's quarters... you don't look like a pirate at all. If you want to go up, there is a small ladder you can climb to the Center Deck.

You can see a Jail Door, eyepatch and pirate coat here.

>n
Crew's Quarters
This is the place where the pirates sleep at night and relax when they can. The Cargo Hold is to the south.

You can see rope and hooking claw here.

    *** A pirate noticed you and you were caught. You Lose. ***

Would you like to RESTART, RESTORE a saved game, QUIT or UNDO the last command?

>undo
Cargo Hold
[Previous turn undone.]

>s
Holding Cell
The jail cell the pirates are keeping you hostage in. There is a tiny barred off window that allows you to see the full moon, the stars in the night sky, and the oil colored ocean. The floor is made out of wooden floorboards and the walls are wood as well. To the north there is an old and rusty jail door.

You can see a Jail Door here.

>n
Cargo Hold
A room where there is pirate clothing and other cargo. The Holding Cell is to the south and the Crew's Quarters are to the north. Be careful though, I wouldn't recommend going into the Crew's quarters... you don't look like a pirate at all. If you want to go up, there is a small ladder you can climb to the Center Deck.

You can see a Jail Door, eyepatch and pirate coat here.

>put on clothes
You can't see any such thing.

I beg your pardon?

>put on eyepatch and pirate coat
You can't see any such thing.

>put on eyepatch
(first taking eyepatch)
You put on eyepatch.

>take pirate
Taken.

>i
You are carrying:
  pirate coat
  eyepatch (being worn)
  wooden oars
  loose floorboard

>put on pirate coat
You put on pirate coat.

>n
Crew's Quarters
This is the place where the pirates sleep at night and relax when they can. The Cargo Hold is to the south.

You can see rope and hooking claw here.

you were able to sneak into the Crew's Quarters unnoticed.

>s
Cargo Hold
A room where there is pirate clothing and other cargo. The Holding Cell is to the south and the Crew's Quarters are to the north. Be careful though, I wouldn't recommend going into the Crew's quarters... you don't look like a pirate at all. If you want to go up, there is a small ladder you can climb to the Center Deck.

You can see a Jail Door here.

>n
Crew's Quarters
This is the place where the pirates sleep at night and relax when they can. The Cargo Hold is to the south.

You can see rope and hooking claw here.

you were able to sneak into the Crew's Quarters unnoticed.

>take rope
Taken.

you were able to sneak into the Crew's Quarters unnoticed.

>take hooking claw
Taken.

you were able to sneak into the Crew's Quarters unnoticed.

>s
Cargo Hold
A room where there is pirate clothing and other cargo. The Holding Cell is to the south and the Crew's Quarters are to the north. Be careful though, I wouldn't recommend going into the Crew's quarters... you don't look like a pirate at all. If you want to go up, there is a small ladder you can climb to the Center Deck.

You can see a Jail Door here.

>use rope
That's not a verb I recognise.

>i
You are carrying:
  hooking claw
  rope
  pirate coat (being worn)
  eyepatch (being worn)
  wooden oars
  loose floorboard

>x rope
You see nothing special about rope.

>x hooking claw
You see nothing special about hooking claw.

>combine hooking claw and rope
You can't use multiple objects with that verb.

>combine claw with rope
you now have a grappling hook.

>use grappling hook
That's not a verb I recognise.

>use hook
That's not a verb I recognise.

>up
Center Deck
As you stand in the center deck you catch the scent of bread coming from the south, the Captain's Quarters. The entry door leads to the Captain's Quarters. Off to the side of the entry you see a wall. The Starboard Deck is to the east, the Port Deck is to the West, the bow is to the north, and the Cargo Hold is below you.

You can see Entry here.

>s
(first opening Entry)
It seems to be locked.

>use hook
That's not a verb I recognise.

>use hook on wall
That's not a verb I recognise.

>e
Starboard Deck
The Center deck is to the west.

* * *

>w
Center Deck
As you stand in the center deck you catch the scent of bread coming from the south, the Captain's Quarters. The entry door leads to the Captain's Quarters. Off to the side of the entry you see a wall. The Starboard Deck is to the east, the Port Deck is to the West, the bow is to the north, and the Cargo Hold is below you.

You can see Entry here.

>x wall
a wall that leads to the roof of the Captain's Quarters if you can manage to climb it.

>use hook
That's not a verb I recognise.

>use grappling hook
That's not a verb I recognise.

>use hook on wall
That's not a verb I recognise.

>climb wall
You throw the grappling claw and it hooks onto the roof. You climb the rope.

roof
You are now above the Captain's Quarters and there is an open hatch that you can go down. From up here you can also scale down to get back down down to the Center Deck.

>i
You are carrying:
  grappling hook
  hooking claw
  rope
  pirate coat (being worn)
  eyepatch (being worn)
  wooden oars
  loose floorboard

>x roof
You can't see any such thing.

>d
Captain's Quarters
The place where the Captain lives when he is not on the deck bossing his crew around.

You can see Entry and bread here.

* * *

>d
You use the hook to scale the wall down to the ground.

Center Deck
As you stand in the center deck you catch the scent of bread coming from the south, the Captain's Quarters. The entry door leads to the Captain's Quarters. Off to the side of the entry you see a wall. The Starboard Deck is to the east, the Port Deck is to the West, the bow is to the north, and the Cargo Hold is below you.

You can see Entry here.

>d
Cargo Hold
A room where there is pirate clothing and other cargo. The Holding Cell is to the south and the Crew's Quarters are to the north. Be careful though, I wouldn't recommend going into the Crew's quarters... you don't look like a pirate at all. If you want to go up, there is a small ladder you can climb to the Center Deck.

You can see a Jail Door here.

>u
Center Deck
As you stand in the center deck you catch the scent of bread coming from the south, the Captain's Quarters. The entry door leads to the Captain's Quarters. Off to the side of the entry you see a wall. The Starboard Deck is to the east, the Port Deck is to the West, the bow is to the north, and the Cargo Hold is below you.

You can see Entry here.

* * *

>talk to seamus
"Hi there. How are you?" you say confidently. 

"Not too good. I'm really hungry." he complains. 

"Are you looking for some food?" you inquire. 

"I'm starving mate. If you have any food, I'd be willing to trade you my knife for it."

>give seamus bread
Seamus is pleased. He gives you the knife.

>s
Center Deck
As you stand in the center deck you catch the scent of bread coming from the south, the Captain's Quarters. The entry door leads to the Captain's Quarters. Off to the side of the entry you see a wall. The Starboard Deck is to the east, the Port Deck is to the West, the bow is to the north, and the Cargo Hold is below you.

You can see Entry here.

>e
Starboard Deck
The Center deck is to the west.

* * *

>w
Port Deck
The Center deck is to the east.

You can see dinghy boat (empty) here.

>use knife on dinghy
That's not a verb I recognise.

>cut rope
Cutting it up would achieve little.

>cut straps with knife
try connecting the oars to the dinghy boat first.

* * *

>connect oars
What do you want to connect wooden oars to?

>connect oars with boat
I didn't understand that sentence.

>connect oars to boat
you attach the wooden oars to the dinghy boat

>go in boat
Now that the oars are attached to the dinghy boat. Try lowering it into the ocean.

>lower broat
That's not a verb I recognise.

>cut straps with knife
the boat drops down into the water. Jump in the dinghy boat before it floats away.

* * *

>x loose floorboard
You see nothing special about loose floorboard.

>take floorboard
Taken.

>pry the jail door with loose floorboard
you break open the jail door.

* * *

>x me
You are tall and skinny but also strong and defined from moving crates and pulling ropes on the ships you have been on throughout your life. Your skin is bronze from the sun and your face is slightly weathered from spending years at sea. You are wearing your sailors hat, a white cotton undergarment, and baige pants. The pirates took your shoes so you are barefoot.

>take floorboard
Taken.

* * *

>w
Port Deck
You can see dinghy boat (empty) here.

>x rope
You see nothing special about rope.

>e
Center Deck

>n
Bow of the Ship
You can see Seamus here.

>s
Center Deck

* * *

>get in dinghy boat
That's not something you can enter.

* * *

>x window
Just a very small window that is barred off with metal bars.

>x floorboards
(loose floorboard)
a two by four plank of hard and very sturdy wood.